NO ./textures/blue.xpm
SO ./textures/Slime.xpm
WE ./textures/Red10.xpm
EA ./textures/brown.xpm

F 187,210,225
C 37,253,233

        111111111111111111111111
        1100000000110000001000001
        1110000011100000010000011
        1001000000000000000000001
111111111111000001110000000000001
100000000011000001110100111111111
10000000000000000000000000001
10000000000000000000000000001
10000001100000000000011000001
1000000110000000000011000001
10000000000000000000000000001
10000000000000000000000000001
11111111111111111111111111111

11111111111111111111111111111
11110111110111011100000010001
11110111110111011101010010001
11000000110101011100000010001
10001000000000000000000000001
10000000000000000001N10000001
110000011101010111110111100111
11110111111101011101111010001
1111111111111111111111111111